NO textures/north.png
SO textures/south.png
WE textures/west.png
EA textures/east.png

C 	 255	  ,		 255		,		  255	 	 	
F 	 100	 ,	 1	 ,	 70 	 	
		  


    1111111111111111111111011111111111111111111111111111111
    1000000000111111111111111111111111111111111111
11111000001000000000000000000011100000000000000001
10000000000000001111111111111100000000000000000001
1000000100000000100000000000000000000000000000011
1000000N0000000001111101111111111111111111111111111
10000000001000000000010100000001111
100000000000000001000000000000000001
100000000000000000000000000001111111
1100000000001111010100000000000000001111111111
111111111111111111111111111111111111
1 1