NO textures/north.png
SO textures/south.png
WE textures/west.png
EA textures/east.png

C 4,234,233
F 100,1,70

11111111111111111111111111111111111111111111111111111
1000000000111111111111111111111111111111111111
1111100000100000000000000000001
100000000000000011111111111111
100000000000000001
1000000N0000000001111111111111111
10000000000000000000000000000001111
100000000000000000000000000000000001
100000000000000000000000000001111111
1100000000001111010100000000000000001111111111
111111111111111111111111111111111111
1 1