NO textures/north.png
SO textures/south.png
WE textures/west.png
EA textures/east.png

F 92,91,86 
C 100,120,140

11111111111111111111111111111111111111111111111111111
1000000000111111111111111111111111111111111111
1111100000100000000000000000000000000000000001
1100000000001111010100N00000000000001111111111
111111111111111111111111111111111111
1 1