NO textures/north.png
EA textures/east.png
SO textures/south.png
WE textures/west.png

C 35,19,3
F 3,6,40

111111111111111
111111000111111
111110000011111
1111000N0001111
110000000000111
110000000000011
101111111100001
110000111000011
111000010000111
111100000001111
111110000011111
111111000111111
111111111111111