NO textures/north.png         	 	 		 	  	
EA textures/east.png  
SO textures/south.png
WE textures/west.png

C	35,19,3
F		3,6,40


11111111111111111111111111111
11100000N000000000000000000011
11111111111111111111111111111